.....................................
.....................................
.....................................
.....................................
......#########################......
.....................................
.....................................
.....................................
.....................................
................##########...........
.....................................
.....................................
.....................................
.....................................
.....................................
.....................................
......######################.........
.....................................
.....................................
.....................................
.....................................
.....................................
.....................................
.....................................
.....................................
.....................................
.....................................
.....................................
.....................................
.....................................
